nPosX	nPosY	map_ID
1859	3295	101
1733	2973	101
1360	2974	101
1390	3334	101
1602	3038	101
1640	3009	101
1683	3018	101
1766	3048	101
1822	3099	101
1840	3178	101
1798	3263	101
1752	3284	101
1553	3277	101
1508	3349	101
1424	3410	101
