nPosX	nPosY	map_ID
2249	4582	121
2065	4281	121
1908	4275	121
1952	4740	121
2082	4468	121
2062	4410	121
1991	4353	121
1926	4349	121
1889	4365	121
1832	4438	121
1827	4510	121
1851	4569	121
1896	4631	121
1948	4694	121
2035	4605	121
